##########
#--------#
#---###--#
D-----#--#
#-#####--#
#-#------#
#-##-----D
#--------#
#--------#
##########