##########
#--------#
#--------#
D--------#
#--------#
#--------#
#--------D
#--------#
#--------#
##########