##########
#-#------#
#---##---#
D---##-#-#
#--###---#
#-#------#
#---#--#-D
#---#----#
#-#-#----#
##########